# wwt.map "World Wrestling Tux"
# Created by James Andrews
# Designed for opening a can of whoop ass on opponents. 
# Events & Entities added by Dave.
Tux 3:16
64 35
wwt.table
nextmap geekusa.map
James Andrews
BASE
4HHHHHHHHHHHvHHHHHvHHvHHHHHHHHHHHHHHHHHHHHHHHHHHHHHHHHHHHvHHvHHH
!!!!!!!!!!![V"""""V..2,,,,,,,,,,,,,,,,,,,,,,,,,,,,,,,,,,,2,,V]!!
!!!!!!!!!!![V""""""..,,,,,,,,,,,,,,,,,,,,,,,,,,,,,,,,,,,,,,,V]!!
!!!!!!!!!!![V"""""V..V,,,,,,,,,,,,,,,,,,,,,,,,,,,,,,,,,,,V,,V]!!
!!!!!!!!!!![V"4H6"V..VERRRY,,,,,,,,,,,,,,,,,,,,,,,,,,,,,,V,,V]!!
!!!!!!!!!!![V"""""V..1HHHHHHHHHHHHHHHH,HHHHHHHHHHHH9,,,,,}H`3]!!
!!!!!!!!!!![V""""""..,,,,,,,,,,,,,,,,,,,,,,,,,,,,,,V,,,,,V``,]!!
!!!!!!!!!!![V"""""V..,,,,ERRRRY,,,ERRY,,,ERRRRRRRY,V,,,,,V``,]!!
!!!!!!!!!!![V"4HHH{..,,,,,,,,,,,,,,,,,,,,,,,,,,,,,,V,,,,,V``,]!!
!!!!!!!!!!![V"""""V..,,,,,,,,,,,,,,,,,,,,,,,,,,,,,,V,,,,,V``,]!!
!!!!!!!!!!![V""""""..,,,,,,,,,,,,,,,,,,,,,,,,,,,,,,V,,,,,V``,]!!
!!!!!!!!!!![V"""""V..,,,,,,,,,,,,,,,,,,,,,,,,,,,,,,19,,,,V`8,]!!
!!!!!!!!7HHs}H6"4H{..,,,,,ERRRRRRRRRRRRRRRRRRY,,,,,,V,,,,V`V,]!!
!!!!!!!!VT,,V""""""..,,,,,,,,,,,,,,,,,,,,,,,,,,,,,,,V,,,,V`V,]!!
!!!!!!!!V?,,V"8"8"V..,,,,,,,,,,,,,,,,,,,,,,,,,,,,,,,V,,,,V`V,]!!
!!!!!!!!1HHH{"V"V"V..,,,,,,,,,,,qwwwwwwe,,,,,,,,,,,,1HHHH3`V,]!!
!!!!!!!!!!![1H^H^H3..ERRRRY,,,,,assssssd,,,T,,,,,,,,,,,,,,`V,]!!
!!!!!!!!!!![.........,,,,,,,,,,,assssssd,,,t,,,,,,,,,,,,,,`V,]!!
!!!!!!!!!!![.........,,,,,,,,,,,assssssd,,,t,,,,,,,,7HHHH9`V,]!!
!!!!!!!!!!![7HHHHH9..ERRRRY,,,,,zxxxxxxc,,,?,,,,,,,,V''''V`V,]!!
!!!!!!!!!!![V.....V..,,,,,,,,,,,mmmmmmmm,,,,,,,,,,,,V''''V`V,]!!
!!!!!!!!!!![V.....V..,,,,,,,,,,,,,,,,,,,,,,,,,,,,,,,V''''V`V,]!!
!!!!!!!!!!![V........,,,,,,,,,,,,,,,,,,,,,,,,,,,,,,,V''''V`V,]!!
!!!!!!!!!!![V.....V..,,,,,ERRRRRRRRRRRRRRRRRRY,,,,,73''''V`V,]!!
!!!!!!!!!!![}HHHHH{..,,,,,,,,,,,,,,,,,,,,,,,,,,,,,,V'''''V`2,]!!
!!!!!!!!!!![V.....V..,,,,,,,,,,,,,,,,,,,,,,,,,,,,,,}6''''V``,]!!
!!!!!!!!!!![V.....V..,,,,,,,,,,,,,,,,,,,,,,,,,,,,,,V'''''V``,]!!
!!!!!!!!!!![V........,,,,,,,,,,,,,,,,,,,,,,,,,,,,,,V'''''V``,]!!
!!!!!!!!!!![V.....V..,,,,ERRRRY,,,ERRY,,,ERRRRRRRY,}6''''V``,]!!
!!!!!!!!!!![V.....V..,,,,,,,,,,,,,,,,,,,,,,,,,,,,,,V'''''V``,]!!
!!!!!!!!!!![}HHHHH{..7HHHHHHHHHHHHHHHHHHHHHHHHHHHHH^6''''}H`9]!!
!!!!!!!!!!![V.....V..V'''''''''''''''''''''''''''''''''''V''V]!!
!!!!!!!!!!![V.....V..V'''''''''''''''''''''''''''''''''''2''V]!!
!!!!!!!!!!![V........'''''''''''''''''''''''''''''''''''''''V]!!
4HHHHHHHHHHH^HHHHH^HH^HHHHHHHHHHHHHHHHHHHHHHHHHHHHHHHHHHHHHH^HHH
OBJECT
--------------t-t-------??Ee-W----e-----Ee------------?-E-------
            -     )  - }VVGBb###GGBbyy#CCBbJCC  ##G#ymV} - y-  -
       ==== -                                               -  -
            -     -  -                                   -  -  -
       ==== - SSS -  -  W  BbccCJJBb     BbCCCCCyyG#/    -  -  -
            - ddd )  -------W--------- -------------|    -  -  -
       ==== -        +                             -|    -^ ~  -
            -     -  +   ----W-   ----   --------/ -\  cC-v ~  -
       ==== - -----  +   JJJJJJ   JJJJ   JJJJJJJJ| -[  cC-  ~  -
            -    s-  +   JJJJJJ   JJJJ   JJJJJJJJ| -m  cC-  ~  -
       ==== -     )  +                           | -G  cC-  ~  -
            -    s-  +                           \ --  cC- -   -
        -0E(--- ---  +    /-W--------------W-/      -  cC- -   -
        -:  -  d     +    |                  | A    -  cC- -   -
        - J - - - -  +    |                  | A    -  CC- -   -
        -L-W-T-T-T-  +    |     78888889     | AA/  -W---- -   -
            -------  ------     4      4   :J| AA|         -   -
                     +          4      4   - | AA|         -   -
                     +         <5      4   :J| AA|  -0000- -   -
       ==== -@-W@--  -----/     1      3   - | AA\  -cccc- -   -
            -M   D-  +    |                  | A    -    - -   -
       ==== -     )  +    |                  | A    -    - -   -
            -Z       +    |                  |      -    - -   -
       ==== -z c y-  +    -----W--------------   / -0    - -   -
            -%---%-  +                           | -P    - -   -
       ==== -McDDD-  +                           | -0    -  ~  -
            -     -  +   KKKKKK   KKKK   KKKKKKK | -P    -  ~  -
       ==== -     )  +   KKKKKK   KKKK   KKKKKKK | -     -  ~  -
            -Z    -  +   ------   ----   --------- -0    -^ ~  -
       ==== -z    -  +                             -Pc   -v ~  -
            -$W-$--  ---------E-------eeeeeeee------0    -  -  -
       ==== -M    -  -&C   &C       G &     &     CcP    -  -  -
            -Z    )  )                                 }}-  -  -
       ==== -z       -                                     y-  -
----------------------------------------------------------------
TOPLEVEL
----------------------------------------------------------------
            -     -  - --------------------------------- - --  -
            -        _                                   _  -  -
            -     -  -                                   -  -  -
            - --- -  -  -  ---------     ------------    -  -  -
            - --- -  ----------------- --------------    - --  -
            -                                      --    -- -  -
            -     -      ------   ----   --------- --  ---- -  -
            - -----      ------   ----   --------- --  ---  -  -
            -    --      ------   ----   --------- --  ---  -  -
            -    -                               - --  ---  -  -
            -    --                              - --  --- -   -
        ------- ---       --------------------      -  --- -   -
        --  -  -          -                  - -    -  --- -   -
        - - - - - -       -                  - -    -  --- -   -
        X----------       -     --------     - ---  ------ -   -
            -------  ------     -      -   --- ---         -   -
                                -      -   - - ---         -   -
                                       -   --- ---  ------ -   -
            -------  ------     -888888-   - - ---  -    - -   -
            --   --       -                  - -    -    - -   -
            -     -       -                  - -    -    - -   -
            --            -                  -      -    - -   -
            -- - --       --------------------   - --    - -   -
            -------                              - --    - -   -
            -------                              - --    -     -
            -     -      ------   ----   ------- - --    -     -
            -     -      ------   ----   ------- - --    -     -
            --           ------   ----   --------- --    --    -
            --    -                                --    --    -
            -------  -----0---------------------0----    - -   -
            --    -  ---   --       - -     -     ---    -     -
            --       -                                         -
            --  --   -                                     -   -
----------------------------------------------------------------
EVENT
----------------------------------------------------------b-----
            -     -  - --------------------------------- - --  -
            -        _                                   _  -  -
            -     -  -                                   -  -  -
            - --- -  -  -  --------- aaa ------------    -  -  -
            - --- -  -----------------A--------------    - B-  -
            -                        aaa           --    --    -
            -     -      ------   ----   --------- --  ----    -
            - -----      ------   ----   --------- --  ---     -
            -    --      ------   ----   --------- --  ---     -
            -    -                               - --  ---     -
            -    --                              - --  --- -   -
        ------- ---       --------------------      -  --- -   -
        --  -  -          -                  - -    -  --- -   -
        - - - - - -       -                  - -    -  --- -   -
        -----------       -     --------     - ---  ------ -   -
            -------  ------     -      -   --- ---         -   -
                                -      -   - - ---         -   -
                                       -   --- ---  ------ -   -
            -------  ------     --------   - - ---  -    - -   -
            --   --       -                  - -    -    - -   -
            -     -       -                  - -    -    - -   -
            --            -                  -      -    - -   -
            -- - --       --------------------   - --    - -   -
            -------                              - --    - -   -
            -------                              - --    -     -
            -     -      ------   ----   ------- - --    -     -
            -     -      ------   ----   ------- - --    -     -
            --           ------   ----   --------- --    --    -
            --    -                                --    --    -
            -------  --------------------------------    --C-  -
            --    -  ---   --       - -     -     ---    -cc-  -
            --       -                                   -  -  -
            --  --   -                                     --  -
----------------------------------------------------------------
EVENTMETA
##### 4 switches { A R V ON }
trigger a y n y n A n 1
door A n y y n KEY=1 <DOOR_H>
trigger b y y y y <SWITCH> B n 1
door B n y y n KEY=1 <DOOR_H>
trigger c y n y n C n 1
door C n y y y KEY=1 <DOOR_H>
ENTITY
SPAWN 64 64 96 0
SPAWN 1728 832 128 0
SPAWN 704 2112 224 0
SPAWN 3072 640 128 0
SPAWN 2560 256 0 0
SPAWN 2624 1984 128 0

CHAINGUN 704 704 0 0
SHOTGUN 2944 60 0 0
CAN 3008 60 0 0
BAZOOKA 2272 1024 0 0
CHAINGUN 896 1984 0 0
BAZOOKA 512 1288 0 0
DEWCAN 640 1360 0 0
CAN 32 2048 0 0
EGUN 32 2112 0 0
CHAINGUN 96 2112 0 0
CAN 3456 1344 0 0
SNIPER 3520 1344 0 0

NODOZE 3840 1024 0 0
BAZOOKA 3840 1088 0 0

BAZOOKA 2820 960 0 0
EGUN 2820 1216 0 0

RAILGUN 2950 1100 0 0

SHOTGUN 3400 908 0 0

SNIPER 1024 1290 0 0

CAN 832 60 0 0
CAN 3136 1980 0 0
